hie_ach_eastern_goods_western_demand	Eastern Goods, Western Demand
hie_ach_grand_court	The Grand Court
hie_ach_assizes_romania	Assizes of Romania
hie_ach_latin_archbishop_patras	Latin Archbishop of Patras
hie_ach_temporal_barons	Temporal Barons
hie_ach_latinized_pronoia	Latinized Pronoia
hie_ach_latin_empire	The Latin Empire
hie_alb_military_conducts	Military Conducts
hie_alb_athleta_christi	Athleta Christi
hie_alb_church_holy_trinity	Church of the Holy Trinity
hie_alb_stratioti	Stratioti
hie_alb_marascallum_regnie_albaniae	Marascallum Regnie Albaniae
hie_alb_legacy_anjou	Legacy of d'Anjou
hie_alb_italian_campaign	Italian Campaign
hie_ath_divine_comedy	Divine Comedy
hie_ath_greek_latin_church	The Greek Latin Church
hie_ath_usages_barcelona	Usages of Barcelona
hie_ath_athens_old	Athens of Old
hie_ath_birthplace_democracy	The Birthplace of Democracy
hie_ath_delian_league	Delian League
hie_ath_modern_hoplites	Modern Hoplites
hie_bos_imperial_law	Imperial Law
hie_bos_caves_kristjani	Caves of the Kristjani
hie_bos_stanak	Stanak
hie_bos_treaties_with_republics	Treaties with the republics
hie_bos_land_princes	Land of the Princes
hie_bos_guaranteed	Guaranteed
hie_bos_bosnian_freedom	Bosnian freedom
hie_bul_slavonic_script	Slavonic Script
hie_bul_fighting_roman_military_art	Fighting the Roman Military Art
hie_bul_ascension_cathedral	Ascension Cathedral 
hie_bul_cuman_fighter	Cuman Fighter
hie_bul_tarnovo_artistic_school	Tarnovo Artistic School
hie_bul_oblast_system	Oblast System
hie_bul_crowned_czar	Crowned Czar
hie_byz_ecumenical_patriarch	Restore the Ecumenical Patriarch
hie_byz_byzantine_renaissance	Byzantine Renaissance
hie_byz_repopulate_countryside	Repopulate the Countryside
hie_byz_administrative_reforms	Administrative Reform
hie_byz_byzantine_bureaucreacy	Byzantine Bureaucracy
hie_byz_merchant_class	Byzantine Merchant Class
hie_byz_new_imperial_army	The New Imperial Army
hie_cep_castles_angels	Castles of the Angels
hie_cep_venetian_ships_greek_sailors	Venetian Ships, Greek Sailors
hie_cep_ancient_training_ground	Ancient Training Grounds
hie_cep_gate_adriatic	Gate to the Adriatic
hie_cep_greko_connections	Greko Connections
hie_cep_birth_new_greece	Birth of the New Greece
hie_cep_pan_hellenism	Pan Hellenism
hie_cro_historia_salonitana	Historia Salonitana
hie_cro_croatian_renaissance	Croatian renaissance
hie_cro_venetian_rivalry	Venetian rivalry
hie_cro_allagions	Allagions
hie_cro_sabor	Sabor
hie_cro_hussars	Hussars
hie_cro_union_with_hungary	Union of with Hungary
hie_crt_new_center_greek_world	The New Center of the Greek World
hie_crt_revolts	The Revolts
hie_crt_venetian_construction	Venetian Construction
hie_crt_new_old_crete	New? Old? We Are Crete
hie_crt_every_port_shipyard	Every Port a Shipyard
hie_crt_ports_chandia_heraklion	Ports of Chandia and Heraklion
hie_crt_venice_east	The Venice of the East, or Is Venice the Crete of the West
hie_epi_despotate_romaniae	Despotes Romaniae
hie_epi_western_orthodox_church	The Western Orthodox Church
hie_epi_latin_weapons_greek_soldiers	Latin Weapons, Greek Soldiers
hie_epi_latin_greek_hellenes	We Are Not Latin, Not Greek We Are Hellenes
hie_epi_latin_technology_greek_wisdom	Latin Technology, Greek Wisdom
hie_epi_venetian_naval_advisor	Venetian Naval Advisors
hie_epi_mare_nostrum	Mare Nostrum
hie_feo_melting_pot_pontic_steppe	Melting Pot of the Pontic Steppe
hie_feo_unification_gothic_imperial_codes	The Unification of the Gothic and Imperial Codes
hie_feo_princesses_theodoro	The Princesses of Theodoro
hie_feo_city_chersones_forts_kalamita_dory	The City of Chersonese and the forts of Kalamita and Dory
hie_feo_reclaiming_gothic_motherland	Reclaiming Our Gothic Motherland
hie_feo_ruthenians_exile	Ruthenians in Exile
hie_feo_spread_gothic_monasteries	The Spread of Gothic Monasteries
hie_gre_gre_home_democracy_philosophy	The Home of Democracy and Philosophy
hie_gre_gre_klepths_armatoloi	Klephts and Armatoloi
hie_gre_gre_navy_legendary	Our Navy Is Legendary!
hie_gre_gre_grand_havens_mediterranean	The Grand Havens of the Mediterranean
hie_gre_gre_remember_past_remember_macedon	Remember Our Past, Remember Macedon
hie_gre_gre_rule_hellespont	We Rule the Hellespont
hie_gre_gre_eleftheria_thanatos	Eleftheria I Thanatos
hie_gre_lat_literal_renaissance	Our Literal Renaissance
hie_gre_lat_greek_latin_church	The Greek Latin Church
hie_gre_lat_reconstruction_parthenon	The Reconstruction of the Parthenon
hie_gre_lat_athens_old	Athens of Old
hie_gre_lat_birthplace_democracy	The Birthplace of Democracy
hie_gre_lat_unite_ancient_leagues	Unite the Ancient Leagues
hie_gre_lat_macedonian_reforms	Macedonian Reforms
hie_hun_order_of_the_dragon	Societas Draconistarum
hie_hun_naszad	Naszad
hie_hun_memories_siege_belgrade	Nandorfehervari Diadale
hie_hun_the_black_army	Fekete Sereg
hie_hun_extraordinary_tax	Extraordinary Tax
hie_hun_decretum_maius	Decretum Maius
hie_hun_bibliotheca_corviniana	Bibliotheca Corviniana
hie_kni_our_crusade_over	Our Crusade Is Not Over
hie_kni_order_army	Our Order Became Many
hie_kni_cultural_allocation_priory_estates	The Cultural Allocation of the Priory Estates
hie_kni_fortification_experts	Fortification Experts
hie_kni_defenders_faith	We Are the Defenders of the Faith
hie_kni_foreign_interest_investments	Foreign Interests and Investment
hie_kni_jerusalem_kingdom_heaven	To Jerusalem, for the Kingdom of Heaven
hie_moe_despotate_mystras	Despots of Mystras
hie_moe_palaelogan_renaissance	The Palaeologan Renaissance
hie_moe_last_rohmanoi	Last of the Rohmanoi
hie_moe_our_refuge_our_citadel	Our Refuge, Our Citadel
hie_moe_establishing_allagia	Establishing the Allagia
hie_moe_reestablishment_themata_pronoia	Re-Establishment of Themata and Pronoia
hie_moe_empire_will_be_ours_again	The Empire Will Be Ours Yet Again
hie_nax_pronoia	Pronoia
hie_nax_assimilation_xenos	Assimilation of the Xenos
hie_nax_reestablishment_aegean_hegemonie	Re-Establishment of the Aegean Hegemonie
hie_nax_traditional_way_life	Traditional Way of Life
hie_nax_wooden_wall	Our Wooden Wall
hie_nax_aegean_battlefield	The Aegean Battlefield
hie_nax_pan_hellenism	Pan Hellenism
hie_rag_saint_blaise	Saint Blaise
hie_rag_liber_statutorum_civitatis_ragusii	Liber statutorum civitatis Ragusii
hie_rag_slavic_latin_union	Slavic-Latin Union
hie_rag_republic_ancona	Republic of Ancona
hie_rag_abolition_slavery	Abolition of Slavery
hie_rag_doors_blakans_orient	The Door to Balkans and Orient
hie_rag_venetian_rivalry	Venetian Rivalry
hie_ser_gusar	Gusar
hie_ser_patriarchate_pec	Patriarchate of Pec
hie_ser_dusan_code	Dušan's Code
hie_ser_dusan_reforms	Dusan's Reforms
hie_ser_dinar	Dinar
hie_ser_gradozandaje	Gradozadanje
hie_ser_vlachs	Vlachs
hie_tur_timarli_sipahi	Timarli Sipahi
hie_tur_slaves_of_sublime_porte	Kapikulu Ocagi
hie_tur_imperial_council	Divan-I Hümayun
hie_tur_osmans_dream	Osman's Dream
hie_tur_indian_ocean_expeditions	Hint Seferleri
hie_tur_bombardiers	Humbaraci
hie_tur_advice_for_the_king	Nasihatname
hie_wal_well_rounded_soldiers	Well Rounded Soldiers
hie_wal_restoring_voivodie	Restoring the Voivodie
hie_wal_european_mongolian_frontier	European-Mongolian Frontier
hie_wal_order_dragon	Order of the Dragon
hie_wal_danube_fortifications	Danube Fortifications
hie_wal_union_of_romanians	Union of Romanians
hie_wal_phanarotie_century	Phanariote Century
hie_cnn_holy_roman_ties	Holy Roman Ties
hie_cnn_bod_an_balcuigh	Bod-An-Balcuigh
hie_cnn_anglo_irish_inheritance_laws	Anglo-Irish Inheritance Laws
hie_cnn_force_issue	Force the Issue
hie_cnn_true_heirs_connacht	True Heirs of Connacht
hie_cnn_atlantic_port_ireland	Atlantic Port of Ireland
hie_cnn_elevation_earl	Elevation to Earl
hie_dms_port_cork	The Port of Cork
hie_dms_defend_gaels	Defend the Gaels
hie_dms_munster_ambition	The Munster Ambition
hie_dms_old_gods	The Old Gods
hie_dms_representative_ireland_abroad	Representative of Ireland Abroad
hie_dms_culture_service	Culture of Service
hie_dms_introduction_potato_ireland	Introduction of the Potato to Ireland
hie_kid_brigid	St. Brigid
hie_kid_more_than_irish	More Than Irish
hie_kid_lords_deputy	Lords Deputy
hie_kid_silver_tongues	Silver Tongues
hie_kid_silken_thomas	Silken Thomas
hie_kid_wizard_earl	The Wizard Earl
hie_kid_franciscan_support	Franciscan Support
hie_fly_clonmacnoise	Clonmacnoise
hie_fly_irish_hospitalities	Irish Hospitality
hie_fly_patronize_irish_music	Patronize Irish Music
hie_fly_pilgrimages_abroad	Pilgrimages Abroad
hie_fly_buonnacht_system	Buonnacht System
hie_fly_tower_churches	Tower Churches
hie_fly_river_trade_experties	River Trade Expertise
hie_ire_high_kingship	High Kingship
hie_ire_brendan_ily_brasil	St. Brendan and Ily Brasil
hie_ire_more_than_irish	More Than Irish
hie_ire_introduction_potatoes	Introduction of Potatoes
hie_ire_peat_cultivation	Peat Cultivation
hie_ire_irish_crofters	Irish Crofters
hie_ire_unconquerable_ireland	Unconquerable Ireland
hie_mcm_red_stag	The Red Stag
hie_mcm_blarney_stone	The Blarney Stone
hie_mcm_norman_frontier	The Norman Frontier
hie_mcm_land_castles	Land of Castles
hie_mcm_brave_faithful	The Brave and the Faithful
hie_mcm_spanish_ties	Spanish Ties
hie_mcm_pirate_heaven	Pirate Haven
hie_mns_dal_gcais_blood	Dal Gcais Blood
hie_mns_reconquest_ireland	Reconquest of Ireland
hie_mns_obrien_legacy	The O'Brien Legacy
hie_mns_reclaim_high_kingship	Reclaim the High Kingship
hie_mns_renovate_cashel	Renovate Cashel
hie_mns_enforce_cios_dubh	Enforce the Cíos Dubh
hie_mns_refuge_gaelic_defiance	Refuge for Gaelic Defiance
hie_mth_book_kells	Book of Kells
hie_mth_rebuild_tara	Rebuild Tara
hie_mth_recover_lost_province	Recover the Lost Province
hie_mth_parliament_ireland	Parliament of Ireland
hie_mth_irish_castellization	Irish Castellization
hie_mth_beyond_pale	Beyond the Pale
hie_mth_welcome_sassenachs	Welcome the Sassenachs
hie_ord_english_service	English Service
hie_ord_patronize_irish_literature	Patronize Irish Literature
hie_ord_resolving_irish_english_feuds	Resolving Irish and English Feuds
hie_ord_lessons_war_roses	Lessons of the War of the Roses
hie_ord_irish_gentlemanly_virtues	Irish Gentlemanly Virtues
hie_ord_english_court	English Court
hie_ord_wool_earl	The Wool Earl
hie_sln_free_gaelic_towns	Free Gaelic Towns
hie_sln_kerns	Kerns
hie_sln_encourage_dyes_trade	Encourage the Dyes Trade
hie_sln_preserve_irish_culture	Preserve Irish Culture
hie_sln_tower_houses_gaelic_castles	Tower Houses and Gaelic Castles
hie_sln_study_norman_militaries	Study Norman Militaries
hie_sln_hell_connacht	To Hell or to Connacht
hie_tyr_true_high_king	True High King
hie_tyr_ui_neill_lineage	UI Neill Lineage
hie_tyr_taking_hostages	Taking of Hostages
hie_tyr_tanistry_law	Tanistry Law
hie_tyr_scottish_brother_kingdom	Scottish Brother Kingdom
hie_tyr_arming_people	Arming the People
hie_tyr_strength_through_negotiation	Strength Through Negotiation
hie_try_last_ancient_kingdoms	Last of the Ancient Kingdoms
hie_try_standardize_gallowglasses	Standardize Gallowglasses
hie_try_st_patrick_cross	St. Patrick's Cross
hie_try_fisher_kings	The Fisher Kings
hie_try_patrick_purgatory	St. Patrick's Purgatory
hie_try_lessons_knockavoe	Lessons of Knockavoe
hie_try_chief_fortress_ireland	Chief Fortress of Ireland
hie_eng_common_law	Common Law
hie_eng_royal_navy	The Royal Navy
hie_eng_acts_union	Acts of Union
hie_eng_acts_concerning_regulation_trade	Acts Concerning the Regulation of Trade
hie_eng_new_model_army	New Model Army
hie_eng_admiralty	The Admiralty
hie_eng_empiricism	Empiricism
hie_sco_declaration_arbroath	Declaration of Arbroath
hie_sco_schiltron	Schiltron
hie_sco_universal_literacy	Universal Literacy
hie_sco_reform_highlander_regiments	Reform the Highlander Regiments
hie_sco_scottish_enlightenment	Scottish Enlightenment
hie_sco_wealth_nations	The Wealth of Nations
hie_sco_industrial_revolution	Industrial Revolution
hie_gbr_trade_and_navigation	The Navigation Acts
hie_gbr_triangle_trade	The Triangle Trade
hie_gbr_eic_patronage	The East India Company
hie_gbr_articles_of_war	Articles of War
hie_gbr_scientific_gunnery	Scientific Gunnery
hie_gbr_redcoats	Redcoats!
hie_gbr_domestic_revolution	Domestic Revolution
hie_arm_legacy_armenian_empire	Legacy of the Armenian Empire
hie_arm_apostolic_church	Apostolic Church
hie_arm_armenian_cataphracts	Armenian Cataphracts
hie_arm_mount_ararat	Mount Ararat
hie_arm_karabkh_horses	Karabakh Horses
hie_arm_valley_copper_wine	Valley of Copper and Wine
hie_arm_cultural_resiliance	Cultural Resilience
hie_avr_footsteps_pannonian_avars	In the Footsteps of the Pannonian Avars
hie_avr_mountaineer_horse_riders	Mountaineer Horse Riders
hie_avr_nomadic_lifestyle	Nomadic Lifestyle
hie_avr_protectors_derbent	Protectors of the Derbent
hie_avr_masterful_metalworkers	Masterful Metalworkers
hie_avr_flexible_alliance	Flexible Alliances
hie_avr_prevent_russian_encroachment	Prevent the Russian Encroachment
hie_cir_head_choppers	Head Choppers
hie_cir_genoese_ties	Genoese Ties
hie_cir_circassian_steppes	Circassian Steppes
hie_cir_federalism	Federalism
hie_cir_cicassian_in_all_courts	Circassians in all courts
hie_cir_papal_correspondence	Papal Correspondence
hie_cir_always_surrounded	Always Surrounded, Never Surrendering
hie_geo_bagrationi_dynasty	Bagrationi Dynasty
hie_geo_last_christian_bastion	The Last Christian Bastion
hie_geo_kipchak_settlements	Kipchak Settlements
hie_geo_campaigns_king_tamar	Campaigns of King Tamar
hie_geo_sadrosho_banners	Sadrosho Banners
hie_geo_shadow_empire	Shadow of an Empire
hie_geo_avenge_battle_chalagan	Avenge the Battle of Chalagan
hie_ime_breaking_yoke_ilkhanate	Breaking the Yoke of the Ilkhanate
hie_ime_genoese_colony_bati	Genoese Colony of Lo Bati
hie_ime_islamic_affiliation	Islamic Affiliation
hie_ime_center_georgian_literature	Center of Georgian literature
hie_ime_persian_ties	Persian Ties
hie_ime_black_sea_port	Black Sea Ports
hie_ime_fertile_black_sea_coast	Fertile Black Sea Coast
hie_mlk_letters_from_byzantines	Letters from the Byzantines
hie_mlk_descendents_kings_artsakh	Descendents of the Kings of Artsakh
hie_mlk_five_melikdoms_karabakh	Five Melikdoms of Karabakh
hie_mlk_karabakh_horses	Karabakh Horses
hie_mlk_syghnakh_recruitment_system	Syghnakh Recruitment System
hie_mlk_last_bastion_armenian_independence	Last Bastion of Armenian Independence
hie_mlk_cultural_resilience	Cultural Resilience
hie_sme_jaqeli_jakeli	Jaqeli and Jakeli
hie_sme_rabati_fortress	Rabati Fortress
hie_sme_gelati_academy	Gelati Academy
hie_sme_legacy_david_builder	Legacy of David the Builder
hie_sme_lessons_ertsukhi	Lessons of Ertsukhi
hie_sme_defenders_faith	Defenders of Faith
hie_sme_ones_who_broke_mongols	The Ones Who Broke the Mongols
hie_srv_bukhara_silk	Bukhara Silk
hie_srv_palace_shirvanshahs	Palace of the Shirvanshahs
hie_srv_kurdish_roots	Kurdish Roots
hie_srv_reforms_manuchihr	Reforms of Manuchihr
hie_srv_kura_river_agriculture	Kura River Agriculture
hie_srv_great_city_shusha	Great city of Shusha
hie_srv_persian_trade	Persian Trade
hie_lit_protectorate_ruthenia	Protectorate of Ruthenia
hie_lit_crusade_against_hordes	Crusade against the Hordes
hie_lit_lithuanian_endurance	Lithuanian Endurance
hie_lit_eastern_balance_power	Eastern Balance of Power
hie_lit_revitilazing_ruthenia	Revitalizing Ruthenia
hie_lit_statutes_lithuania	Statutes of Lithuania
hie_lit_lithuanian_renaissance	Lithuanian Renaissance
hie_plc_pol_rebirth	Odrodzenie
hie_plc_pol_pacta_conventa	Pacta Conventa
hie_plc_pol_warsaw_confederation	Konfederacja Warszawska
hie_pol_pospolite_ruszenie	Pospolite Ruszenie
hie_pol_winged_hussars	Skrzydlata Husaria
hie_plc_pol_magnates	Magnateria
hie_plc_pol_computed_army	Wojsko Komputowe
hie_plc_lit_rebirth	Odrodzenie
hie_plc_lit_gediminid_legacy	Gediminaiciai Palikimas
hie_plc_lit_amend_golden_liberty	Amended Golden Liberty
hie_plc_lit_pospolite_ruszenie	Pospolite Ruszenie
hie_plc_lit_winged_hussars	Skrzydlata Husaria
hie_plc_lit_magnates	Magnateria
hie_plc_lit_computed_army	Wojsko Komputowe
hie_pol_gaude_mater_polonia	Gaude Mater Polonia
hie_pol_union_of_krewo	Union of Krewo
hie_pol_constitutional_monarchy	Monarchia Stanowa
hie_pol_commonwealth	Rzeczpospolitas
hie_pol_pospolite_ruszenie	Pospolite Ruszenie
hie_pol_winged_hussars	Skrzydlata Husaria
hie_pol_permanent_defense	Obrona Potoczna
hie_mos_elevate_muscovite_metropolitan_patriarch	Elevate Muscovite Metropolitan to Patriarch
hie_mos_ugorschina	Ugorshchina
hie_mos_tsar_vseya_rossii	T'sar Vseya Rossii
hie_mos_zasechnaya_cherta	Zasechnaya Cherta
hie_mos_relentless_push	Relentless Push
hie_mos_samoderzhaviye	Samoderzhaviye
hie_mos_sloboda	Sloboda
hie_nov_ledovoye_poboishche	Ledovoye Poboishche
hie_nov_nogorodckaya_prevaya_letopis	Novgorodskaya Pervaya Letopis.
hie_nov_ushkuyiniks	Ushkuiniks
hie_nov_novgorodian_belka	Novgorodian Belka
hie_nov_veliki_novgorod	Veliky Novgorod
hie_nov_continuation_veche	Continuation of the Veche
hie_nov_zavolochye	Zavolochye
hie_rus_mos_serfdom	Krepostnichestvoh
hie_rus_mos_siberian_frontiers	Siberian Frontiers
hie_rus_mos_third_rome	Trety Rim
hie_rus_mos_conscription_obligation	Voinskaya Povinnost
hie_rus_mos_metropolitan_of_all_rus	Metropolitan of Kiev and All RUS
hie_rus_mos_sloboda	Sloboda
hie_rus_mos_new_order	Polki Novovo Stroya
hie_rus_nov_homeland_trade	Homeland Trading Policies
hie_rus_nov_siberian_frontiers	Siberian Frontiers
hie_rus_nov_cold_water	Kholodnaya Voda
hie_rus_nov_skhariya_the_jew	Zhidovstvuyushchiye
hie_rus_nov_new_ushkuiniks	Reformed Ushkuiniks
hie_rus_nov_window_on_west	Window on the West
hie_rus_nov_veche_of_all_rus	Veche of All RUS
hie_ukr_chornozem	Chornozem
hie_ukr_vissko_zaporozke	Viisko Zaporozke
hie_ukr_siberian_frontiers	Siberian Frontiers
hie_ukr_veliky_kiev	Veliky Kyiv
hie_ukr_metropolitan_of_rus_and_kiev	Metropolitan of Kyiv and All RUS
hie_ukr_kleinody	Kleinody
hie_ukr_bratstvo	Bratstvo
hie_ayu_mahatthai	Krasuang Mahatthai
hie_ayu_chatusadom	Chatusadom
hie_ayu_bunga_emas_dan_perak	Bunga Emas Dan Perak
hie_ayu_floating_rice	Floating Rice
hie_ayu_sakdina	Sakdina
hie_ayu_phrai_conscription	Phrai Conscription
hie_ayu_ban_yipun	Ban Yipun
hie_maj_thalassocracy_mandala	A Thalassocratic Mandala
hie_maj_nagarakretagama	Nagarakretagama
hie_maj_cetbang	Eastern and Western Style Cetbang
hie_maj_palapa_oath	Sumpah Palapa
hie_maj_star_path_navigation	Star Path Navigation
hie_maj_armada	Jong, Malangbang and Kelulu Armadas
hie_maj_partners_with_common_order	Mitreka Satata
hie_msa_suvarnabhumi	Suvarnabhumi
hie_msa_adoption_cetbang	Adoption of the Cetbang
hie_msa_sea_people	Sea People
hie_msa_ilmu_bedil	Ilmu Bedil
hie_msa_bendahara	Bendahara
hie_msa_alam_melayu	Alam Melayu
hie_msa_daulat	Daulat
hie_sia_songkram_yudhahatthi	Songkram Yuddhahatthi
hie_sia_chatusadom	Chatusadom
hie_sia_expell_westerners	Expelling Western Meddlers
hie_sia_floating_rice	Floating Rice
hie_sia_phra_chao_phaendin	Phra Chao Phaendin
hie_sia_golden_age	Golden Age of Ayutthaya
hie_sia_dap_hak	Dap Hak
hie_jap_free_market_guilds	Rakuichi Rakuza
hie_jap_bakuhan	Bakuhan
hie_jap_bushido	Bushido
hie_jap_tanegashima	Tanegashima
hie_jap_red_seal_ships	Shuinsen
hie_jap_terakoya	Terakoya
hie_jap_rice_brokers	Fudasashi
hie_kor_hanguel	Hanguel
hie_kor_hwacha_chongtong	Hwachas and Chongtong
hie_kor_gwageo	Gwageo
hie_kor_samsa	Samsa
hie_kor_righteous_armies	Righteous Armies
hie_kor_geobukseon	Geobukseon
hie_kor_silhak	Silhak
hie_mng_neige	Nèigé
hie_mng_jiubian	Jiubian
hie_mng_haijin	Haijin
hie_mng_barabian_recruits	Barbarian Recruits
hie_mng_ming_porcelain	Ming Porcelain
hie_mng_single_whip_law	Single Whip Law
hie_mng_folangji	Folangji
hie_fra_compagnies_d_ordonnance	Les Compagnies D'Ordonnance
hie_fra_grands_vieux_corps	Les Six Grands Vieux
hie_fra_ordinance_villers_cotterets	L'Ordonnance de Villers-Cotterêts
hie_fra_coureur_des_bois	Coureurs Des Bois
hie_fra_dragonnades	Les Dragonnades
hie_fra_chambres_des_reunions	Les Chambres de Réunions
hie_fra_because_it_is_our_good_pleasure	Car Tel Est Notre Plaisir
hie_bri_black_riders	Black Riders
hie_bri_arthurian_legends	Arthurian Legends
hie_bri_protective_treaties	Protective Treaties
hie_bri_beyond_our_shores	Beyond Our Shores
hie_bri_cooperative_trade_deals	Cooperative Trade Deals
hie_bri_people_sea	People of the Sea
hie_bri_catholicon	Catholicon
hie_bur_order_of_golden_fleece	The Distinguished Order of the Golden Fleece
hie_bur_combined_arms	Students of Warfare
hie_bur_compagnies_d_ordinnance	Les Compagnies D'Ordonnance
hie_bur_chambres_des_comptes	Chambres Des Comptes
hie_bur_estate_general_of_netherlands	Estates General of the Netherlands
hie_bur_great_council_of_mechelen	The Great Council of Mechelen
hie_bur_burgundian_state	L'État Bourguignon
hie_lot_distinguished_order_golden_fleece	The Distinguished Order Of The Golden Fleece
hie_lot_students_warfare	Students Of Warfare
hie_lot_compagnies_ordonnance	Les Compagnies D'Ordonnance
hie_lot_chambres_comptes	Chambres Des Comptes
hie_lot_lotharingian_abbeys	Lotharingian abbeys
hie_lot_ancient_imperial_capital	The Ancient Imperial capital
hie_lot_pax_francia	Pax Francia
hie_aac_acquis_granum	Aquis-Granum
hie_aac_plats_charlemagne	The Plats of charlemagne
hie_aac_dom_aken	The Dom of Aken
hie_aac_walls_aken	The walls of Aken
hie_aac_imperial_capital	The imperial capital
hie_aac_old_limburg	Old Limburg
hie_aac_pax_francia	Pax Francia
hie_als_strasburg_cathedral	Straßburg Cathedral
hie_als_kirchenfabriken	Kirchenfabriken
hie_als_franco_allemanic_melting_pot	Franco-Allemanic Melting Pot
hie_als_printed_word	The Printed Word
hie_als_religious_agreements	Religious Agreements
hie_als_confessio_tetrapolitana	Confessio Tetrapolitana
hie_als_gates_rhine	Gates of the Rhine
hie_anh_allodium	Allodium
hie_anh_many_princes_only_one_princedom	Many princes only one Princedom
hie_anh_wolfgang_confessor	Wolfgang the Confessor
hie_anh_anhalt_militarisation	Anhalt militarisation
hie_anh_adoption_prussian_system	Adoption of the Prussian system
hie_anh_duchy_anhalt	The Duchy of Anhalt
hie_anh_anhalt_constitution	The Anhalt constitution
hie_aug_builders_churches_abbeys	Builders of churches and abbeys
hie_aug_right_coinage	The right of coinage
hie_aug_free_city_augsburg	The free city of Augsburg
hie_aug_encouragement_printing_press	Encouragement of the printing press
hie_aug_patronage_bishops	The patronage bishops
hie_aug_peace_augsburg	The Peace of Augsburg
hie_aug_jesuit_counter_reformation	Jesuit counter-reformation
hie_boh_wagenbbug	Vozová Hradba
hie_boh_sirotci	Sirotci
hie_boh_compacta	Compactata
hie_boh_university_of_prague	Universitatis Carolinae Ferdinandeae
hie_boh_diplomatic_treatise	Tractatus Pacis Toti Christianitati Fiendae
hie_boh_bergordnung	Bergordnung
hie_boh_zrizene_zemske	Zemska Zrizeni
hie_bra_nordmark	Nordmark
hie_bra_pomeranian_wars	The Pomeranian Wars
hie_bra_kammergericht	The Kammergericht
hie_bra_hohenzollern_claims	Claims of the Hohenzollern
hie_bra_berlin_gymnasium	Berlinisches Gymnasium
hie_bra_jachimica_constitutio	Constitutio Joachimica
hie_bra_teuton_influence	Teutonic Influence
hie_bre_bremer_dykes_polders	Bremer dykes and polders
hie_bre_bremer_hansa	Bremer Hansa
hie_bre_food_market_northern_europe	The food market of Northern Europe
hie_bre_bremer_shipyards	Bremer shipyards
hie_bre_bremerhaven	Bremerhaven
hie_bre_fierce_independence	Fierce independence
hie_bre_new_world_trading_port	New world trading port
hie_brg_gallia_belgica	Gallia Belgica
hie_brg_whupper_valley	Whupper Valley: 
hie_brg_united_duchies	United Duchies
hie_brg_via_media	Via Media
hie_brg_uniting_rhine	Uniting the Rhine
hie_brg_imperial_honour	Imperial Honour
hie_brg_early_industrialisation	Early industrialization
hie_cob_veste_coburg	Veste Coburg
hie_cob_jewish_district	Jewish District
hie_cob_luther_study	Luther's Study
hie_cob_gymnasium_casimirianum	Gymnasium Casimirianum
hie_cob_schloss_ehrenburg	Schloss Ehrenburg
hie_cob_art_diplomacy	The Art of Diplomacy
hie_cob_dynasty_many_crowns	Dynasty of many crowns
hie_dtt_geestland	Geestland
hie_dtt_wrecking	Wrecking
hie_dtt_the_joke_that_is_aristocracy	The joke that is aristocracy
hie_dtt_come_and_get_it	“Come and get it”
hie_dtt_containing_feudalism	Containing feudalism
hie_dtt_peaceful_front_yard	A peaceful front yard
hie_dtt_our_feudes	Our feudes
hie_fkn_imperial_lineages	Imperial Lineages
hie_fkn_inextinguishable_title	Inextinguishable Title
hie_fkn_knights_franconian_orders	Knights of the Franconian Orders
hie_fkn_curb_raubritter	Curb the Raubritter
hie_fkn_franconian_reformation	Franconian Reformation
hie_fkn_nichtabgeschlossenes_gebiet	Nichtabgeschlossenes Gebiet
hie_fkn_franconian_brewing_expterise	Franconian Brewing Expertise
hie_frn_ruins_nida	The Ruins of Nida
hie_frn_council_frankfurt	Council of Frankfurt
hie_frn_frankfurter_messe	Frankfurter Messe
hie_frn_we_are_capital_once_more	We are the capital once more
hie_frn_frankfurt_exchange	The Frankfurt Exchange
hie_frn_neutrality	Neutrality
hie_frn_beating_heart_german_nation	The Beating Heart of the german nation
hie_ger_regierungsbezirke	Regierungsbezirke
hie_ger_divided_faith_united_purpose	Divided in Faith, United in Purpose
hie_ger_real_union	Real Union
hie_ger_stechschritt	Der Stechschritt
hie_ger_standesherren	Standesherren
hie_ger_wartburgfest	Wartburgfest
hie_ger_zollverein	Zollverein
hie_ger_schwarz_rod_gold	Schwarz, Rod, Gold
hie_ger_national_assembly	National Assembly
hie_ger_unification_of_germania	Unification of Germania
hie_ger_bundesrepublik	Bundesrepublik
hie_ger_pressefreiheit_und_fressefreiheit	Pressefreiheit und Fressefreiheit
hie_ger_people_army	The People's Army
hie_ger_reichsflotte	Reichsflotte
hie_gnv_great_council_geneva	Great Council of Geneva
hie_gnv_assembly_halberds	Assembly of the Halberds
hie_gnv_protestant_rome	Protestant Rome
hie_gnv_genevan_psalter	Genevan Psalter
hie_gnv_wathmaking_city	The Watchmaking City
hie_gnv_early_welfare_system	Early Welfare System
hie_gnv_citoyens_geneve	Citoyens de Geneve
hie_hab_felix_austria	Felix Austria
hie_hab_fugger_banking	Fugger Banking
hie_hab_pietas_austriacae	Pietas Austriacae
hie_hab_hofkriegsrat	Hofkriegsrat
hie_hab_militargrenze	Militargrenze
hie_hab_neuafteilung_der_erblande	Neuaufteilung Der Erblande
hie_hab_austriae_est_imperare_orbi_universo	Austriae EST Imperare Orbi Universo
hie_ham_old_new_hamburg	Old and New Hamburg
hie_ham_sister_city_lubeck	The sister city of Lübeck
hie_ham_territoriale_politik	Territoriale Politik
hie_ham_imperial_right_prosecute	The imperial right to prosecute
hie_ham_secularisation	Secularisation
hie_ham_citadel_hamburg	The citadel that is Hamburg
hie_ham_ambivalente_position_stadt_hamburg	Ambivalente Position der Stadt Hamburg
hie_han_res_gestae_saxonicae_sive_annalium_libri_tres	Res gestae Saxonicae sive annalium libri tres
hie_han_kurkhannover	Khurhannover Kurhannover
hie_han_legally_indivisible	Legally Indivisible
hie_han_naturally_protestant	Naturally Protestant
hie_han_feoffment	Feoffment
hie_han_privy_council_hannover	Privy Council of Hannover
hie_han_real_union	Real Union
hie_hes_thuringian_connections	Thuringian connections
hie_hes_military_leadership_schmalkaldic_league	Military leadership of the Schmalkaldic league
hie_hes_safe_haven_reformation	Safe haven for the reformation
hie_hes_imperial_auxiliaries	The imperial Auxiliaries
hie_hes_rivalries_protestant_universities	The rivalries of the Protestant universities
hie_hes_grossmutig	Großmütig
hie_hes_standersherren	Standesherren
hie_hlr_reform_the_landsknechte	Reform the Landsknechte
hie_hlr_chancellery_of_the_empire	Chancellery of the Empire
hie_hlr_prussian_influence	Prussian Influence
hie_hlr_wise_electors	Wise Electors
hie_hlr_gutenberg_press	Gutenberg's Press
hie_hlr_reichslandwirtschaftsausstellung	Reichslandwirtschaftsausstellung
hie_hlr_imperial_concessions	Imperial Concessions
hie_hlr_bur_the_distinguished_order_of_the_golden_fleece	The Distinguished Order Of The Golden Fleece
hie_hlr_bur_students_of_warfare	Students Of Warfare
hie_hlr_bur_the_ancient_imperial_capital	The Ancient Imperial capital
hie_hlr_bur_renovatio_imperii_romanorum	Renovatio imperii Romanorum
hie_hlr_bur_renaissance_after_renaissance	Renaissance after Renaissance
hie_hlr_bur_the_burgundian_circle	The Burgundian circle
hie_hlr_bur_a_modern_standing_army	A modern standing army
hie_hlr_boh_vozova_hradba	Vozová Hradba
hie_hlr_boh_compactata	Compactata
hie_hlr_boh_universitatis_carolinae_ferdinandeae	Universitatis Carolinae Ferdinandeae
hie_hlr_boh_teutonic_respect	Teutonic respect
hie_hlr_boh_the_reinstatement_of_a_true_reichsgut	The reinstatement of a true Reichsgut
hie_hlr_boh_standardize_the_prager_groschen	Standardize the Prager groschen
hie_hlr_boh_the_legacy_of_house_luxembourg	The legacy of house Luxembourg
hie_hlr_hab_felix_austria	Felix Austria
hie_hlr_hab_neuaufteilung_der_erblande	Neuaufteilung Der Erblande
hie_hlr_hab_austriae_est_imperare_orbi_universo	Austriae Est Imperare Orbi Universo
hie_hlr_hab_catholic_supremacy	Catholic Supremacy
hie_hlr_hab_the_diet_of_worms	The Diet of Worms
hie_hlr_hab_the_foundations_for_capitalism	The foundations for capitalism
hie_hlr_hab_imperial_baroque	Imperial Baroque
hie_hlr_lat_birthplace_of_renaissance	Birthplace Of Renaissance
hie_hlr_lat_armata_imperiale	Armata Imperiale
hie_hlr_lat_statuta_sabaudiae	Statuta Sabaudiae
hie_hlr_lat_cordone_giallo	Cordone Giallo
hie_hlr_lat_the_iron_crown	The Iron Crown
hie_hlr_lat_e_pluribus_unum	E Pluribus Unum
hie_hlr_lat_southern_marches	Southern Marches
hie_hsa_kontors	Kontors
hie_hsa_lubsiches_recht	Lübisches Recht
hie_hsa_schiffskinder	Schiffskinder
hie_hsa_monopoly_shipbuilding	Monopoly on Shipbuilding
hie_hsa_drittel_quartiere	Drittel Quartiere
hie_hsa_abkommen_hanse	Abkommen der Hanse
hie_hsa_queen_baltic	Queen of the Baltic
hie_kle_city_clovers	The City of Clovers
hie_kle_knight_swan	Knight of the Swan
hie_kle_limbourg_old	Limbourg of Old
hie_kle_wachter_klever_reichswald	Wächter des Klever Reichswald
hie_kle_via_media	Via Media
hie_kle_rhine_toll	Rhine Toll
hie_kle_know_our_name	They Know our Name
hie_kol_imperial_concessions	Imperial Concessions:
hie_kol_erblandesvereinigung	Erblandesvereinigung
hie_kol_free_city_cologne	Free City of Cologne
hie_kol_gaffeln	Gaffeln
hie_kol_papal_nunciature	Papal Nunciature
hie_kol_flexible_diplomacy	Flexible Diplomacy
hie_kol_council_prime_minister_cathedral_chapter	Council, Prime Minister, and Cathedral Chapter
hie_lpp_allodium	Allodium
hie_lpp_city_builders	City builders
hie_lpp_samtherrschaft	Samtherrschaft
hie_lpp_pactum_unionis	Pactum unionis
hie_lpp_fluidity_religion	The fluidity of religion
hie_lpp_astronomiae_instauratae_mechanica	Astronomiae instauratae mechanica
hie_lpp_old_saxon_reformed	Old Saxon reformed
hie_mai_gutenberg_press	Gutenberg's Press
hie_mai_institutionalized_simony	Institutionalized Simony
hie_mai_archicancellarius_germania	Archicancellarius per Germania
hie_mai_found_university_mainz	Found the University of Mainz
hie_mai_weck_worscht_woi	Weck, Worscht, and Woi
hie_mai_restricted_masonry	Restricted Masonry
hie_mai_city_nobility	City of the Nobility
hie_mva_fortification_experts	Fortification experts
hie_mva_saint_rastislav	Saint Rastislav
hie_mva_colloquium_generale	Colloquium generale
hie_mva_lessons_learned	Lessons learned
hie_mva_morravian_industrie	Morravian Industrie
hie_mva_union_with_bohemia	Union with Bohemia
hie_mva_dream_great_moravia	The dream that was Great Moravia
hie_nsa_river_tools	River Tolls
hie_nsa_zunfte	Zunfet
hie_nsa_tenacious_rebuilders	Tenacious Rebuilders
hie_nsa_rhenish_circles	Rhenish Circles
hie_nsa_lowland_dynasties	Lowland Dynasties
hie_nsa_german_viticulture	German Viticulture
hie_nsa_romanticism	Romanticism
hie_num_castle_nuremberg	Castle of Nuremberg
hie_num_reichsschultheiss	Reichsschultheiß
hie_num_unofficial_capital	The unofficial capital
hie_num_grosser_freiheitsbrief	Großer Freiheitsbrief
hie_num_abolishment_guilds	Abolishment of the guilds
hie_num_german_renaissance	The German Renaissance
hie_num_tanzstatus	Tanzstatut
hie_old_descendants_widukind	Descendants of Widukind
hie_old_enemies_on_all_sides	Enemies on all sides
hie_old_rivalry_with_frisians	Rivalry with the Frisians
hie_old_kings_kalmar_union	Kings of the Kalmar Union
hie_old_soldier_dukes	Soldier Dukes
hie_old_unity_above_all	Unity above all
hie_old_imperial_tolls	Imperial tolls
hie_pad_irminsul	Irminsul
hie_pad_libori	Libori
hie_pad_neuhaus_palace	Neuhaus Palace
hie_pad_hochstift_paderborn	Hochstift Paderborn
hie_pad_jesuitenuniversitat	Jesuitenuniversität
hie_pad_kleinmeister	Kleinmeister
hie_pad_franco_prussian_influence	Franco-Prussian Influence
hie_pal_imperial_vicars	Imperial Vicars
hie_pal_chancellery_empire	Chancellery of the Empire
hie_pal_heidelberg_university	Heidelberg University
hie_pal_bibliotheca_palatina	Bibliotheca Palatina
hie_pal_religious_disputations	Religious Disputations
hie_pal_compulsory_education	Compulsory Education
hie_pal_mannheim_school_music	Mannheim School of Music
hie_pru_prussian_virtues	Preußische Tugenden
hie_pru_movement_warfare	Bewegungskrieg
hie_pru_kantonsystem	Kantonsystem
hie_pru_fall_manoeuvres	Herbstübung
hie_pru_goosestep	Der Stechschritt
hie_pru_prussian_drill	Preußische Disziplin
hie_pru_schooling_system	Bildungsreform
hie_rot_imperial_swabia	Imperial Swabia
hie_rot_pre_planne_city	Pre-planned city
hie_rot_territoriale_politik	Territoriale Politik
hie_rot_legal_ambiguity	Legal ambiguity
hie_rot_defense_budget	Defense budget
hie_rot_swabian_reformation	Swabian reformation
hie_rot_cultural_renaissance	Cultural renaissance
hie_rva_westfalischer_hellweg	Westfälischer Hellweg
hie_rva_our_rights_our_city	Our rights our city
hie_rva_legalization_reformation	The legalization of the reformation
hie_rva_hanseatic_capital_rhine	The Hanseatic capital of the Rhine
hie_rva_imperial_notoriety	Imperial Notoriety
hie_rva_ruhr_industry	Ruhr industry
hie_rva_reichsdeputationshauptschluss	Reichsdeputationshauptschluss
hie_sax_sachsenspiege	Sachsenspiegel
hie_sax_dual_electorship	Dual Electorship
hie_sax_wise_electors	Wise Electors
hie_sax_meisner_porcelain	Meissner Porcelain
hie_sax_wittenberg_university	Wittenberg University
hie_sax_corpus_evangelicorum	Corpus Evangelicorum
hie_sax_saxon_circle	The Saxon Circle
hie_shl_where_germans_clash	Where Germans clash
hie_shl_city_builders	City builders
hie_shl_back_forth	Back and forth
hie_shl_treaty_ribe	Treaty of Ribe
hie_shl_reformation_germanification	The Reformation Germanification
hie_shl_codex_holmiensis	Codex Holmiensis
hie_shl_holstein_condominium	The Holstein condominium
hie_slz_festung_hohensalzburg	Festung Hohensalzburg
hie_slz_residenzstadt	Residenzstadt
hie_slz_transalpine_infrastructure	Transalpine Infrastructure
hie_slz_center_counter_reformation	Center of Counter-Reformation
hie_slz_true_neutrality	True Neutrality
hie_slz_german_baroque	German Baroque
hie_slz_magic_boy_trials	Magic Boy Trials
hie_sor_spreewald_und_grenzwall	Spreewald und Grenzwall
hie_sor_lusatian_textiles	Lusatian textiles
hie_sor_protestant_refuge	Protestant Refuge
hie_sor_estate_assembly	Estate assembly
hie_sor_silver_mines	Silver mines
hie_sor_lusatian_hussars	Lusatian Hussars
hie_sor_revival_sorbian_identity	Revival of the Sorbian identity
hie_sty_die_steiermark	Die Steiermark
hie_sty_lower_styria	Lower Styria
hie_sty_land_monasteries	Land of monasteries
hie_sty_georgenberger_handfeste	Georgenberger Handfeste
hie_sty_vertrag_von_neuberg	Vertrag von Neuberg
hie_sty_university_graz	University of Graz
hie_sty_marchia_carantana	Marchia Carantana
hie_swa_cradle_dynasties	Cradle of Dynasties
hie_swa_schwabischer_stadtebund	Schwäbischer Städtebund
hie_swa_landsknechte	Landsknechte
hie_swa_reichsfreiheit	Reichsfreiheit
hie_swa_divided_faith_united_purpose	Divided in Faith, United in Purpose
hie_swa_swabian_circle	Swabian Circle
hie_swa_swabian_industriousness	Swabian Industriousness
hie_swi_drills_drums	Drills and Drums
hie_swi_alpine_defensiveness	Alpine Defensiveness
hie_swi_swiss_farming_techniques	Swiss Farming Techniques
hie_swi_three_languages_one_culture	Three Languages, One Culture
hie_swi_debate_religious_issues	Debate Religious Issues
hie_swi_the_calling	The Calling
hie_swi_universal_conscription	Universal Conscription
hie_teu_grossschaffer	Großschäffer
hie_teu_shiffskinder	Schiffskinder
hie_teu_preussischer_landtag	Preußischer Landtag
hie_teu_eastern_crusade	Eastern Crusade
hie_teu_knights_empire	Knights of the Empire
hie_teu_magister_germaniae	Magister Germaniae
hie_teu_prussian_junkers	Prussian Junkers
hie_thu_altes_thuringen	Altes Thüringen
hie_thu_dux_sorabici_limitis_duces_thuringorum	Dux Sorabici Limitis et Duces Thuringorum
hie_thu_das_land_burgen_schlosser	Das Land der Burgen und Schlösser
hie_thu_alte_stamme	Alte Stämme
hie_thu_sangerkrieg	Sängerkrieg
hie_thu_teutonic_ties	Teutonic Ties
hie_thu_thuringian_succession	Thuringian succession
hie_tir_alps_are_our_friend	The alps are our friends
hie_tir_imperial_passes	Imperial passes
hie_tir_forts_valleys	Forts and valleys
hie_tir_de_jure_flexibility	De Jure flexibility
hie_tir_tiroler_silver	Tiroler silver
hie_tir_imperial_mint	Imperial Mint
hie_tir_kingmakers	Kingmakers
hie_tri_roman_infrastructure	Roman infrastructure
hie_tri_archicancellarius_galliam	Archicancellarius per Galliam
hie_tri_concilie_trento	Concilie of Trento
hie_tri_university_trier	University of Trier
hie_tri_landwirtschaftsausstellung	Landwirtschaftsausstellung
hie_tri_seamless_robe_jesus	Seamless Robe of Jesus
hie_tri_bridge_between_empires	Bridge between empires
hie_ttl_league_gods_house	League of Gods House
hie_ttl_gray_league	Gray League
hie_ttl_league_ten_jurisdictions	League of ten jurisdictions
hie_ttl_three_leagues	The Three Leagues
hie_ttl_expanding_league	Expanding the league
hie_ttl_landfrieden	Landfrieden
hie_ttl_control_over_alpine_passes	Control over the alpine passes
hie_wes_mountains_deep_forests	Mountains and deep forests
hie_wes_people_not_state	A people not a state
hie_wes_imperial_founding	Imperial founding
hie_wes_westphalian_way	Westphalian way
hie_wes_catholic_saxons	Catholic Saxons
hie_wes_westphalian_system	Westphalian system
hie_wes_old_saxony	Old Saxony
hie_ans_oberland_unterland	Oberland und Unterland
hie_ans_franconian_circle	The Franconian circle
hie_ans_ordre_sincerite	Ordre de la Sincérité
hie_ans_flexible_loyalty	Flexible loyalty
hie_ans_prussian_family	Prussian family
hie_ans_gravenreuther_stift	Gravenreuther Stift
hie_ans_ansbacher_fayence_manufaktur	Ansbacher Fayence-Manufaktur
hie_byt_oberland_unterland	Oberland und Unterland
hie_byt_franconian_circle	The Franconian circle
hie_byt_ordre_sincerite	Ordre de la Sincérité
hie_byt_flexible_loyalty	Flexible loyalty
hie_byt_prussian_family	Prussian family
hie_byt_gravenreuther_stift	Gravenreuther Stift
hie_byt_ansbacher_fayence_manufaktur	Ansbacher Fayence-Manufaktur
hie_bav_lex_baiuvariorum	Lex Baiuvariorum
hie_bav_frankish_heritage	Frankish Heritage
hie_bav_teilherzogtumer	Teilherzogtümer
hie_bav_regierungsbezirke	Regierungsbezirke
hie_bav_reinheitsgebot	Reinheitsgebot
hie_bav_bavarian_circle	The Bavarian Circle
hie_bav_imperial_rivalries	Imperial Rivalries
hie_ing_lex_baiuvariorum	Lex Baiuvariorum
hie_ing_frankish_heritage	Frankish Heritage
hie_ing_teilherzogtumer	Teilherzogtümer
hie_ing_regierungsbezirke	Regierungsbezirke
hie_ing_reinheitsgebot	Reinheitsgebot
hie_ing_bavarian_circle	The Bavarian Circle
hie_ing_imperial_rivalries	Imperial Rivalries
hie_lbv_lex_baiuvariorum	Lex Baiuvariorum
hie_lbv_frankish_heritage	Frankish Heritage
hie_lbv_teilherzogtumer	Teilherzogtümer
hie_lbv_regierungsbezirke	Regierungsbezirke
hie_lbv_reinheitsgebot	Reinheitsgebot
hie_lbv_bavarian_circle	The Bavarian Circle
hie_lbv_imperial_rivalries	Imperial Rivalries
hie_ubv_lex_baiuvariorum	Lex Baiuvariorum
hie_ubv_frankish_heritage	Frankish Heritage
hie_ubv_teilherzogtumer	Teilherzogtümer
hie_ubv_regierungsbezirke	Regierungsbezirke
hie_ubv_reinheitsgebot	Reinheitsgebot
hie_ubv_bavarian_circle	The Bavarian Circle
hie_ubv_imperial_rivalries	Imperial Rivalries
hie_bam_supreme_control_clergy	Supreme control of the Clergy
hie_bam_suffragan_duties	Suffragan duties
hie_bam_foundation_church	Foundation of the church
hie_bam_religious_volunteers	Religious volunteers
hie_bam_counter_reformation	Counter-reformation
hie_bam_clerical_diplomacy	Clerical diplomacy
hie_bam_peace_augsburg	Peace of Augsburg
hie_lie_supreme_control_clergy	Supreme control of the Clergy
hie_lie_suffragan_duties	Suffragan duties
hie_lie_foundation_church	Foundation of the church
hie_lie_religious_volunteers	Religious volunteers
hie_lie_counter_reformation	Counter-reformation
hie_lie_clerical_diplomacy	Clerical diplomacy
hie_lie_peace_augsburg	Peace of Augsburg
hie_mag_supreme_control_clergy	Supreme control of the Clergy
hie_mag_suffragan_duties	Suffragan duties
hie_mag_foundation_church	Foundation of the church
hie_mag_religious_volunteers	Religious volunteers
hie_mag_counter_reformation	Counter-reformation
hie_mag_clerical_diplomacy	Clerical diplomacy
hie_mag_peace_augsburg	Peace of Augsburg
hie_mun_supreme_control_clergy	Supreme control of the Clergy
hie_mun_suffragan_duties	Suffragan duties
hie_mun_foundation_church	Foundation of the church
hie_mun_religious_volunteers	Religious volunteers
hie_mun_counter_reformation	Counter-reformation
hie_mun_clerical_diplomacy	Clerical diplomacy
hie_mun_peace_augsburg	Peace of Augsburg
hie_osn_supreme_control_clergy	Supreme control of the Clergy
hie_osn_suffragan_duties	Suffragan duties
hie_osn_foundation_church	Foundation of the church
hie_osn_religious_volunteers	Religious volunteers
hie_osn_counter_reformation	Counter-reformation
hie_osn_clerical_diplomacy	Clerical diplomacy
hie_osn_peace_augsburg	Peace of Augsburg
hie_pss_supreme_control_clergy	Supreme control of the Clergy
hie_pss_suffragan_duties	Suffragan duties
hie_pss_foundation_church	Foundation of the church
hie_pss_religious_volunteers	Religious volunteers
hie_pss_counter_reformation	Counter-reformation
hie_pss_clerical_diplomacy	Clerical diplomacy
hie_pss_peace_augsburg	Peace of Augsburg
hie_tnt_supreme_control_clergy	Supreme control of the Clergy
hie_tnt_suffragan_duties	Suffragan duties
hie_tnt_foundation_church	Foundation of the church
hie_tnt_religious_volunteers	Religious volunteers
hie_tnt_counter_reformation	Counter-reformation
hie_tnt_clerical_diplomacy	Clerical diplomacy
hie_tnt_peace_augsburg	Peace of Augsburg
hie_ver_supreme_control_clergy	Supreme control of the Clergy
hie_ver_suffragan_duties	Suffragan duties
hie_ver_foundation_church	Foundation of the church
hie_ver_religious_volunteers	Religious volunteers
hie_ver_counter_reformation	Counter-reformation
hie_ver_clerical_diplomacy	Clerical diplomacy
hie_ver_peace_augsburg	Peace of Augsburg
hie_wbg_supreme_control_clergy	Supreme control of the Clergy
hie_wbg_suffragan_duties	Suffragan duties
hie_wbg_foundation_church	Foundation of the church
hie_wbg_religious_volunteers	Religious volunteers
hie_wbg_counter_reformation	Counter-reformation
hie_wbg_clerical_diplomacy	Clerical diplomacy
hie_wbg_peace_augsburg	Peace of Augsburg
hie_bad_decapole	Decapole
hie_bad_imperial_cities	Imperial Cities
hie_bad_landsknechte	Landsknechte
hie_bad_regierungsbezirke	Regierungsbezirke
hie_bad_lederhosen	Lederhosen
hie_bad_schlosser_festunge_und_burgen	Schlösser und Burgen
hie_bad_volksfeste	Volkfeste
hie_mbz_decapole	Decapole
hie_mbz_imperial_cities	Imperial Cities
hie_mbz_landsknechte	Landsknechte
hie_mbz_regierungsbezirke	Regierungsbezirke
hie_mbz_lederhosen	Lederhosen
hie_mbz_schlosser_festunge_und_burgen	Schlösser und Burgen
hie_mbz_volksfeste	Volkfeste
hie_dwt_decapole	Decapole
hie_dwt_imperial_cities	Imperial Cities
hie_dwt_landsknechte	Landsknechte
hie_dwt_regierungsbezirke	Regierungsbezirke
hie_dwt_lederhosen	Lederhosen
hie_dwt_schlosser_festunge_und_burgen	Schlösser und Burgen
hie_dwt_volksfeste	Volkfeste
hie_knz_decapole	Decapole
hie_knz_imperial_cities	Imperial Cities
hie_knz_landsknechte	Landsknechte
hie_knz_regierungsbezirke	Regierungsbezirke
hie_knz_lederhosen	Lederhosen
hie_knz_schlosser_festunge_und_burgen	Schlösser und Burgen
hie_knz_volksfeste	Volkfeste
hie_mem_decapole	Decapole
hie_mem_imperial_cities	Imperial Cities
hie_mem_landsknechte	Landsknechte
hie_mem_regierungsbezirke	Regierungsbezirke
hie_mem_lederhosen	Lederhosen
hie_mem_schlosser_festunge_und_burgen	Schlösser und Burgen
hie_mem_volksfeste	Volkfeste
hie_mlh_decapole	Decapole
hie_mlh_imperial_cities	Imperial Cities
hie_mlh_landsknechte	Landsknechte
hie_mlh_regierungsbezirke	Regierungsbezirke
hie_mlh_lederhosen	Lederhosen
hie_mlh_schlosser_festunge_und_burgen	Schlösser und Burgen
hie_mlh_volksfeste	Volkfeste
hie_reg_decapole	Decapole
hie_reg_imperial_cities	Imperial Cities
hie_reg_landsknechte	Landsknechte
hie_reg_regierungsbezirke	Regierungsbezirke
hie_reg_lederhosen	Lederhosen
hie_reg_schlosser_festunge_und_burgen	Schlösser und Burgen
hie_reg_volksfeste	Volkfeste
hie_ulm_decapole	Decapole
hie_ulm_imperial_cities	Imperial Cities
hie_ulm_landsknechte	Landsknechte
hie_ulm_ulmierungsbezirke	Regierungsbezirke
hie_ulm_lederhosen	Lederhosen
hie_ulm_schlosser_festunge_und_burgen	Schlösser und Burgen
hie_ulm_volksfeste	Volkfeste
hie_wur_decapole	Decapole
hie_wur_imperial_cities	Imperial Cities
hie_wur_landsknechte	Landsknechte
hie_wur_wurierungsbezirke	Regierungsbezirke
hie_wur_lederhosen	Lederhosen
hie_wur_schlosser_festunge_und_burgen	Schlösser und Burgen
hie_wur_volksfeste	Volkfeste
hie_gos_ostsiedlung	Ostsiedlung
hie_gos_saxon_heritage	Saxon Heritage
hie_gos_hansa	Hansa
hie_gos_eastern_northern_marks	Eastern and Northern Marks
hie_gos_vernacular_german	Vernacular German
hie_gos_integrated_firearms	Integrated Firearms
hie_gos_lessons_thirty_years_war	Lessons of the Thirty Years' War
hie_lau_ostsiedlung	Ostsiedlung
hie_lau_saxon_heritage	Saxon Heritage
hie_lau_hansa	Hansa
hie_lau_eastern_northern_marks	Eastern and Northern Marks
hie_lau_vernacular_german	Vernacular German
hie_lau_integrated_firearms	Integrated Firearms
hie_lau_lessons_thirty_years_war	Lessons of the Thirty Years' War
hie_mkl_ostsiedlung	Ostsiedlung
hie_mkl_saxon_heritage	Saxon Heritage
hie_mkl_hansa	Hansa
hie_mkl_eastern_northern_marks	Eastern and Northern Marks
hie_mkl_vernacular_german	Vernacular German
hie_mkl_integrated_firearms	Integrated Firearms
hie_mkl_lessons_thirty_years_war	Lessons of the Thirty Years' War
hie_rup_ostsiedlung	Ostsiedlung
hie_rup_saxon_heritage	Saxon Heritage
hie_rup_hansa	Hansa
hie_rup_eastern_northern_marks	Eastern and Northern Marks
hie_rup_vernacular_german	Vernacular German
hie_rup_integrated_firearms	Integrated Firearms
hie_rup_lessons_thirty_years_war	Lessons of the Thirty Years' War
hie_bru_true_heirs_saxony	True heirs of Saxony
hie_bru_skilled_art_marriage	Skilled in the art of marriage
hie_bru_saxon_military_culture	Saxon Military culture:
hie_bru_saxon_circle	The Saxon Circle
hie_bru_saxon_hussars	Saxon Hussars
hie_bru_schwarze_legion	Schwarze Legion
hie_bru_realm_henry_lion	The realm of henry the lion
hie_clb_true_heirs_saxony	True heirs of Saxony
hie_clb_skilled_art_marriage	Skilled in the art of marriage
hie_clb_saxon_military_culture	Saxon Military culture:
hie_clb_saxon_circle	The Saxon Circle
hie_clb_saxon_hussars	Saxon Hussars
hie_clb_schwarze_legion	Schwarze Legion
hie_clb_realm_henry_lion	The realm of henry the lion
hie_lun_true_heirs_saxony	True heirs of Saxony
hie_lun_skilled_art_marriage	Skilled in the art of marriage
hie_lun_saxon_military_culture	Saxon Military culture:
hie_lun_saxon_circle	The Saxon Circle
hie_lun_saxon_hussars	Saxon Hussars
hie_lun_schwarze_legion	Schwarze Legion
hie_lun_realm_henry_lion	The realm of henry the lion
hie_pom_bridge_between_germans_slavs	Bridge between Germans and Slavs
hie_pom_lands_house_griffin	The lands of House Griffin
hie_pom_kammin_diocese	Kammin diocese
hie_pom_duchy_slavinia	The duchy of Slavinia
hie_pom_ostsiedlung	Ostsiedlung
hie_pom_backyard_hanseatic_league	Backyard of the Hanseatic League
hie_pom_pomeranian_church	The Pomeranian church
hie_rug_bridge_between_germans_slavs	Bridge between Germans and Slavs
hie_rug_lands_house_griffin	The lands of House Griffin
hie_rug_kammin_diocese	Kammin diocese
hie_rug_duchy_slavinia	The duchy of Slavinia
hie_rug_ostsiedlung	Ostsiedlung
hie_rug_backyard_hanseatic_league	Backyard of the Hanseatic League
hie_rug_pomeranian_church	The Pomeranian church
hie_ste_bridge_between_germans_slavs	Bridge between Germans and Slavs
hie_ste_lands_house_griffin	The lands of House Griffin
hie_ste_kammin_diocese	Kammin diocese
hie_ste_duchy_slavinia	The duchy of Slavinia
hie_ste_ostsiedlung	Ostsiedlung
hie_ste_backyard_hanseatic_league	Backyard of the Hanseatic League
hie_ste_pomeranian_church	The Pomeranian church
hie_wol_bridge_between_germans_slavs	Bridge between Germans and Slavs
hie_wol_lands_house_griffin	The lands of House Griffin
hie_wol_kammin_diocese	Kammin diocese
hie_wol_duchy_slavinia	The duchy of Slavinia
hie_wol_ostsiedlung	Ostsiedlung
hie_wol_backyard_hanseatic_league	Backyard of the Hanseatic League
hie_wol_pomeranian_church	The Pomeranian church
hie_adu_medical_advancements	Medical Advancements
hie_adu_encourage_al_kimiya	Encourage Al-Kimiya
hie_adu_true_successor_caliphate	True Successor to the Caliphate
hie_adu_taifa_administration	Taifa Administration
hie_adu_propagate_maliki_school	Propagate the Maliki School
hie_adu_import_berber_armies	Import Berber Armies
hie_adu_secure_african_trade	Secure the African Trade
hie_ara_almogavars	Almogavars
hie_ara_crown_aragon	Crown of Aragon
hie_ara_feuros_aragon	Fueros de Aragón
hie_ara_thalassocracy	Thalassocracy
hie_ara_consulate_sea	Consulate of the Sea
hie_ara_trading_halls	Trading Halls
hie_ara_taula_canvi	Taula de Canvi
hie_asu_reconquista	Reconquista
hie_asu_santiago_matamoros	Santiago Matamoros
hie_asu_strategic_depopulation	Strategic Depopulation
hie_asu_refuge_mozarabs	Refuge for Mozarabs
hie_asu_cruz_victoria	Cruz de la Victoria
hie_asu_asturian_art	The Asturian Art
hie_asu_first_crusader_kings	First Crusader Kings
hie_cas_people_war	People of War
hie_cas_toledo_steel	Toledo Steel
hie_cas_royal_universities	Royal Universities
hie_cas_inter_caetera	Inter Caetera
hie_cas_encomienda	Encomienda
hie_cas_imperator_hispaniae	Imperator Hispaniae
hie_cas_castilian_language	Castilian Language
hie_cat_generalitat_catalunya	Generalitat de Catalunya
hie_cat_catalan_constitutions	Catalan Constitutions
hie_cat_sagramental	Sagramental
hie_cat_catalan_galleys	Catalan Galleys
hie_cat_catalan_company	The Catalan Company
hie_cat_consell_cent	Consell de Cent
hie_cat_remenca_pagesos	Remença de Los Pagesos
hie_gal_always_armed	Always Armed
hie_gal_sanctuaria_santiago	Sanctuaria de Santiago
hie_gal_camino_real	El Camino Real
hie_gal_fogar_breogan	Fogar de Breógan
hie_gal_santiago_cierra	Santiago Y Cierra
hie_gal_maritime_highways	Maritime Highways
hie_gal_irmandinos	Irmandiños
hie_gra_al_zillij	Al-Zillij
hie_gra_al_andalus	Al-Andalus
hie_gra_volunteers_faith	Volunteers of the Faith
hie_gra_strait_fibraltar	Strait of Gibraltar
hie_gra_use_old_build_new	Use Old to Build the New
hie_gra_canals_cisterns_towers	Canals, Cisterns, and Towers
hie_gra_garnata_al_yahud	Garnata Al-Yahud
hie_lon_cortes	Cortes
hie_lon_order_santiago	Order of Santiago
hie_lon_hidalgos	Hidalgos
hie_lon_concilions_feuros_leyes	Concilios, Fueros, Y Leyes
hie_lon_continue_reconquista	Continue the Reconquista
hie_lon_school_salamanca	School of Salamanca
hie_lon_expression_faith	Expressions of Faith
hie_mjo_privative_kingdom	Privative Kingdom
hie_mjo_haven_slave_trade	Haven for the Slave Trade
hie_mjo_misquelets	Miquelets
hie_mjo_lliures_morts	Lliures O Morts
hie_mjo_raid_moros	Raid the Moros
hie_mjo_island_harbors	Island Harbors
hie_mjo_insular_council	Insular Council
hie_nav_moros_costa	Moros en la Costa
hie_nav_follow_whale_migrations	Follow the Whale Migrations
hie_nav_navarrese_company	Navarrese Company
hie_nav_protective_trade_deals	Beneficial Trade Deals
hie_nav_royal_basque_society	Royal Basque Society
hie_nav_beret	The Beret
hie_nav_carlism	Carlism
hie_por_new_age_sail	A New Age of Sail
hie_por_black_swords	The Black Swords
hie_por_early_adoption_gunpowder	Early Adoption of Gunpowder
hie_por_tordesillas	Tordesillas
hie_por_feitorias	Feitorias
hie_por_cartazes	Cartazes
hie_por_portolan_charts	Portolan Charts
hie_val_heritage_balansiyya	Heritage of Balansiyya
hie_val_integrate_mudejar	Integrate the Mudejar
hie_val_twice_loyal	Twice Loyal
hie_val_llotja_seda	Llotja de la Seda
hie_val_valencia_oranges	Valencia Oranges
hie_val_germanies	Germanies
hie_val_cradle_iberia	Cradle of Iberia
hie_spa_catholic_monarchs	Catholic Monarchs
hie_spa_casa_contracion	Cása de Contración
hie_spa_inter_caetera	Inter Caetera
hie_spa_global_currency	Global Currency
hie_spa_spanish_inquisition	Spanish Inquisition
hie_spa_gregoria_calendar	Gregorian Calendar
hie_spa_guerrilla_warfare	Guerilla Warfare
hie_dlh_indo_mussalman_nobles	Indo-Mussalman Nobility
hie_dlh_double_defense	A Two Pronged defense
hie_dlh_streamlined_diwan	Streamlined Diwan
hie_dlh_kharaj	Kharaj
hie_dlh_zawabit	Zawabit
hie_dlh_decimal_organisation	Decimal Hierarchies
hie_dlh_against_rajputs	Stand Against Rajputana
hie_bng_shah_i_bangalah	Shah-I-Bangalah
hie_bng_sikanders_peace	Peace of Sikander Shah
hie_bng_dual_currency	Coin and Cowry
hie_bng_golden_age_of_sufism	The Golden Age of Sufism
hie_bng_habshi_imports	Habshi Imports
hie_bng_growth_of_bhati	Bountiful Harvests in the Bhati
hie_bng_holy_water	Gangajal
hie_guj_jamat_bandi	Jamat Bandi
hie_guj_garba	Garba!
hie_guj_lipi	Gujarati Lipi
hie_guj_svetembara_banking	Svetembara Banking
hie_guj_bab_el_makkah	Bab-El Makkah
hie_guj_vanya_merchants	Vanya Merchants
hie_guj_begada	Begada
hie_jnp_sangitasiromani	Sangitasiromani
hie_jnp_lord_of_the_east	Malik-Us-Sharqi
hie_jnp_treaties_and_laws	Treatises on Theology and Law
hie_jnp_zamindar_army	Zamindars and Peasant Warriors
hie_jnp_shiraz_i_hind	Shiraz-I-Hind
hie_jnp_abode_of_peace	The Abode of Peace
hie_jnp_bahri_horses	Bahri and Tatari
hie_mar_hindavi_swarajya	Hindavi Swarajya
hie_mar_ganimi_kawa	Ganimi Kawa
hie_mar_kunbi	Kunbi
hie_mar_modern_bureacracy	Ashta Pradhan
hie_mar_navy	The Maratha Navy
hie_mar_forts	Hilltop Forts
hie_mar_peshwa	The Peshwa
hie_mer_kumbhalgarh	Protected by Kumbhalgarh
hie_mer_victory_tower	Vijay Stambah
hie_mer_bravery_over_arms	Bravery, Not Arms
hie_mer_free_brothers_from_jizya	Free the Brothers From Jizya!
hie_mer_rajput_confederacy	Lead the Confederation
hie_mer_city_of_lakes	Udaipur: City of Lakes
hie_mer_leonidus_of_rajasthan	Leonidus of Rajasthan
hie_mug_ali_quli	Legacy of Ali Quli
hie_mug_sawar_and_zat	Sawar and Zat Ranks
hie_mug_subahs	Subahs
hie_mug_guns_and_cannons	Shirazi Volleys and Zafarbaksh
hie_mug_madi_i_maash	Madad-I Ma'Ash
hie_mug_fatawa_i_almgiri	Fatawa-i-Alamgiri
hie_mug_agricultural_reforms	Hierarchical Agrarian Reforms
hie_ori_suryavamsi_militarism	Suryavamsi Militarism
hie_ori_servitors_of_jagannath	Servitors of Jagannath
hie_ori_angavala	Angavala
hie_ori_titles	Gajapati Gaudesvara Nava Koti Karnata Kalavargesvara
hie_ori_sasans	Royal Sasans
hie_ori_rajya	Dandapata and Rajya
hie_ori_bhakt_vaishnavism	Bhakti and Vaishnavism
hie_vij_amaranayaka_sainya	Amaranayaka Sainya
hie_vij_council_of_ministers	The Council of Ministers
hie_vij_varnasramadharma	Varnasramadharma
hie_vij_amaramakni	Amaramakni
hie_vij_astadiggajas	Astadiggajas
hie_vij_virabanajigas_paradesi	Virabanajigas and Paradesi
hie_vij_city_of_victory	Vijayanagara and Hampi
hie_fer_estensi	Gli Estensi
hie_fer_condotte_militari	Condotte Militari
hie_fer_addizione_erculea	Addizione Erculea
hie_fer_mecenatismo_estense	Mecenatismo Estense
hie_fer_castello_estense	Castello Estense
hie_fer_corti_imperiali	Corti Imperiali
hie_fer_fonderie_ferraresi	Fonderie Ferraresi
hie_gen_genoese_crossbowmen	Balestrieri Genovesi
hie_gen_vivaldi_noli_malfante	Vivaldi, Noli E Malfante
hie_gen_genoese_colonies	Colonie Genovesi
hie_gen_ianuensis_ergo_mercator	Ianuensis Ergo Mercator
hie_gen_officium_sancti_georgii	Officium Sancti Georgii
hie_gen_gazaria_rules	Regole Di Gazaria
hie_gen_galleys_magistrate	Magistrato Delle Galee
hie_ita_culla_rinascimento	Culla Del Rinascimento
hie_ita_milizia	Milizia
hie_ita_arsenali_marittimi	Arsenali Marittimi
hie_ita_repubbliche_marinare	Repubbliche Marinare
hie_ita_corti_imperiali	Corti Imperiali
hie_ita_fortificazione_italiana	Fortificazione All'Italiana
hie_ita_pianure_alluvionali	Pianure Alluvionali
hie_luc_capitale_marca_tuscia	Capitale della Marca di Tuscia
hie_luc_henrici_iv_diplomata	Henrici IV Diplomata
hie_luc_consoli_maggiori	Consoli Maggiori
hie_luc_cinque_porte_lucca	Cinque Porte di Lucca
hie_luc_xii_anziani	XII Anziani
hie_luc_mura_lucca	Mura di Lucca
hie_luc_universita_lucca	Università di Lucca
hie_man_gonzaga	I Gonzaga
hie_man_condotte_military	Condotte Militari
hie_man_celeste_galleria	Celeste Galleria
hie_man_quattro_laghi_di_mincio	Quattro Laghi Di Mincio
hie_man_cordone_giallo	Cordone Giallo
hie_man_ghetto_mantovano	Ghetto Mantovano
hie_man_corti_imperiali	Corti Imperiali
hie_mfa_montferratian_viticulture	Montferratian Viticulture
hie_mfa_leadership_fourth_crusade	Leadership in the Fourth Crusade
hie_mfa_palaiologos_rule	Palaiologos Rule
MFA_byzantine_claimants	Last Claimants of Byzantium
hie_mfa_rolling_hills_montferrat	Rolling Hills of Montferrat
hie_mfa_french_savoyard_influence	French and Savoyard Influence
hie_mfa_greco_italian_heritage	Greco-Italian Heritage
hie_mlo_piastra_milanese	Piastra Alla Milanese
hie_mlo_camera_mercanti	Camera Dei Mercanti
hie_mlo_espansione_viscontea	Espansione Viscontea
hie_mlo_ufficio_governatore_statuti	Ufficio Del Governatore Degli Statuti
hie_mlo_armata_ducale	Armata Ducale
hie_mlo_naviglio_grande	Naviglio Grande
hie_mlo_centro_commercio_padano	Centro Del Commercio Padano
hie_nap_sicilian_kingship	Sicilian Kingship
hie_nap_repubblica_salerno	Repubblica Di Salerno
hie_nap_liber_augustalis	Liber Augustalis
hie_nap_universita_federico	Università Federico II
hie_nap_conquista_ladislao	Conquista Di Ladislao
hie_nap_transumanza	Transumanza
hie_nap_castella	Le Castella
hie_pap_patrimonii_sancti_peter	Patrimonii Sancti Peter
hie_pap_bibliotheca_apostolica_vaticana	Bibliotheca Apostolica Vaticana
hie_pap_vicarius_christi	Vicarius Christi
hie_pap_camera_domini_papae	Camera Domini Papae
hie_pap_liber_constitutionum_sanctae_matris_ecclesiae	Liber Constitutionum Sanctae Matris Ecclesiae
hie_pap_acriter__fideliter	Acriter et Fideliter
hie_pap_dicasterium_pro_doctrina_fidei	Dicasterium Pro Doctrina Fidei
hie_pga_ercolano_perugia	Ercolano Di Perugia
hie_pga_governo_artigiano	Governo Artigiano
hie_pga_braccio_montone	Braccio Di Montone
hie_pga_signoria_perugina	Signoria Perugina
hie_pga_rinascimento_baglioni	Rinascimento Dei Baglioni
hie_pga_guerra_sale	Guerra Del Sale
hie_pga_rocca_paolina	Rocca Paolina
hie_pis_crusading_traditions	Crusading Traditions
hie_pis_empori_meridionali	Empori Meridionali
hie_pis_gesta_triumphalia_pisanos	Gesta Triumphalia per Pisanos
hie_pis_rinascimento_toscano	Rinascimento Toscano
hie_pis_liber_maiolichinus	Liber Maiolichinus
hie_pis_foce_arno	Foce Dell'Arno
hie_pis_repubblica_tirrena	Repubblica Tirrena
hie_sar_nuraghi	Nuraghi
hie_sar_giudicati_sardi	Giudicati Sardi
hie_sar_porto_torres	Porto Torres
hie_sar_defensive_tactics	Defensive Tactics
hie_sar_arborea	I D'Arborea
hie_sar_miniere_sarde	Miniere Sarde
hie_sar_marchesato_oristano	Marchesato D'Oristano
hie_sav_cittadella	Cittadella
hie_sav_franco_italian_influence	Franco-Italian Influence
hie_sav_northern_meddling	Northern Meddling
hie_sav_decima	Decima
hie_sav_legion_allobroges	Legion Des Allobroges
hie_sav_statuta_sabaudiae	Statuta Sabaudiae
hie_sav_venaria_reale	Venaria Reale
hie_sic_sicilian_kingship	Sicilian Kingship
hie_sic_norman_knights	Norman Knights
hie_sic_parramentu_sicilianu	Parramentu Sicilianu
hie_sic_vespri_siciliani	Vespri Siciliani
hie_sic_bellezza_sicilia	La Bellezza Della Sicilia
hie_sic_spanish_heritage	Spanish Heritage
hie_sic_stretto_sicilia	Stretto Di Sicilia
hie_sie_lupa_sienese	Lupa Sienese
hie_sie_ospedale_santa_maria_scale	Ospedale Santa maria delle Scale
hie_sie_palio_siena	Palio di Siena
hie_sie_duomo_siena	Duomo di Siena
hie_sie_cristallo_colle_val_elsa	Cristallo Colle Val d'Elsa
hie_sie_monte_paschi_siena	Monte dei Paschi di Siena
hie_sie_accademia_intronati	Accademia degli Intronati
hie_spi_artistical_resurgence	Artistical Resurgence
hie_spi_real_esercito	Regia Armata Sarda
hie_spi_istruzione_gesuita	Istruzione Gesuita
hie_spi_fusione_perfetta	Fusione Perfetta
hie_spi_accademia_reale_torino	Accademia Reale Di Torino
hie_spi_cassa_ecclesiastica	Cassa Ecclesiastica
hie_spi_tentativu_industriare	Tentativu Industriare
hie_szo_discendenza_aleramica	Discendenza Aleramica
hie_szo_vasto	Del Vasto
hie_szo_po_valley	The Po Valley
hie_szo_marchese_statuti	Il Marchese e gli Statuti
hie_szo_santa_maria_vergine_assunta	Santa Maria Vergine Assunta
hie_szo_comunita_ebraica_saluzzo	Comunità Ebraica di Saluzzo
hie_szo_francia_savoia	Francia e Savoia
hie_tts_constitutio_amalfitana	Constitutiones Regni Siciliarum
hie_tts_crown_two_sicilies	Crown of the Two Sicilies
hie_tts_arsenali_marittimi	Arsenali Marittimi
hie_tts_real_esercito	Real Esercito
hie_tts_pubblica_istruzione	Pubblica Istruzione
hie_tts_transumanza	Transumanza
hie_tts_flotta_commerciale	Flotta Commerciale
hie_tus_pavese	Pavese
hie_tus_birthplace_renaissance	Birthplace of Renaissance
hie_tus_bande_toscane	Bande Toscane
hie_tus_uffizi	Uffizi
hie_tus_riforma_terra	Riforma Di Terra
hie_tus_fiorino_oro	Fiorino D'Oro
hie_tus_artigianato_fiorentino	Artigianato Fiorentino
hie_urb_condotte_military	Condotte Militari
hie_urb_maiolica	Maiolica
hie_urb_federico_montefeltro	Federico da Montefeltro
hie_urb_rinascimento_urbinate	Rinascimento urbinate
hie_urb_piero_francesca	Piero della Francesca
hie_urb_studio_biblioteca	Studio e Biblioteca
hie_urb_palazzo_ducale_urbino	Palazzo Ducale di Urbino
hie_ven_arsenale_veneziano	Arsenale Veneziano
hie_ven_armada	Armada
hie_ven_vetro_murano	Vetro Murano
hie_ven_savij_alle_acque	Savij alle Acque
hie_ven_fanti_mar	Fanti Di Mar
hie_ven_aldina	Aldina
hie_ven_galeazza	Galeazza
hie_vrn_santa_maria_antica	Santa Maria Antica
hie_vrn_scaligeri_verona	Scaligeri di Verona
hie_vrn_signoria_veronese	Signoria Veronese
hie_vrn_stella_forte	Stella Forte
hie_vrn_rinasciemnto_scaligeri	Rinascimento degli Scaligeri
hie_vrn_epoca_scaligera	Epoca Scaligera
hie_vrn_baroni_randazzo	Baroni di Randazzo
hie_cyp_kingdom_lusignan	The Kingdom of the Lusignan
hie_cyp_safe_haven_strategic_base	Safe Haven or Strategic Base
hie_cyp_byzantine_refugees	Byzantine Refugees
hie_cyp_cooperation_orders	Cooperation With the Orders
hie_cyp_house_ibelin	The House of Ibelin
hie_cyp_fortress_monasteries	Fortress Monasteries
hie_cyp_christian_entrepot_east	The Christian Entrepot of the East
hie_koj_kni_our_order_became_many	Our Order Became Many
hie_koj_kni_fortification_experts	Fortification Experts
hie_koj_kni_navel_world	The Navel of the World
hie_koj_kni_duties_continue	Our Duties Can Continue
hie_koj_kni_all_are_welcome	All Are Welcome
hie_koj_kni_reestablishing_our_banks	Reestablishing our Banks
hie_koj_kni_empire_heaven	The Empire of Heaven
hie_koj_navel_world	The Navel of the World
hie_koj_return_orders	The Return of the Orders
hie_koj_all_are_welcome	All Are Welcome
hie_koj_house_belin	The House of Ibelin
hie_koj_blooming_desert	The Blooming Desert
hie_koj_legacy_leper_king	Legacy of the Leper King
hie_koj_empire_outremer	The Empire of Outremer
hie_koj_lat_patiarcha_latinus	Patriarcha Latinus
hie_koj_lat_nostri_iunctiones_roma	Nostri Unctiones Roma
hie_koj_lat_legioni_christiani	Legioni Christiani
hie_koj_lat_reditus_orrdinus_sanctorum	Reditus Ordinus Sanctorum
hie_koj_lat_arces_terrae_sanctae_nostrae	Arces Terrae Sanctae Nostrae
hie_koj_lat_reviviscens_latinaea_iudaeae	Reviviscens Latinaea Iudaeae
hie_koj_lat_imperium_caelorum	Imperium Caelorum
hie_mam_royal_mamluks	The Royal Mamluks
hie_mam_mamluk_architecture	Mamluk Architecture
hie_mam_hisbah	Hisbah
hie_mam_amir_arab	Amir al-Arab
hie_mam_self_appointed_qadi_qudah	Self Appointed Qadi al-Qudah
hie_mam_ustadar_aliyah	Ustadar al-Aliyah
hie_mam_khushdashiyyah	Khushdashiyyah
hie_tre_last_rhomanoi	Last of the Rhomanoi
hie_tre_komnenos_dynasty	The Komnenos Dynasty
hie_tre_between_mountains_sea	Between the Mountains and the Sea
hie_tre_new_constantinople	The New Constantinople
hie_tre_acts_vazelon	The Acts of Vazelon
hie_tre_princes_lazes	The Princes of the Lazes
hie_tre_emperors_once_more	Emperors Once More
hie_brb_stadsrechten_belforten	Stadsrechten en Belforten
hie_brb_brusselse_wandtapijten	Brusselse Wandtapijten
hie_brb_het_ziekenhuis_ninove	Het Ziekenhuis Van Ninove
hie_brb_faceting	Faceting!
hie_brb_opkomst_antwerpen	De Opkomst Van Antwerpen
hie_brb_gilden_brussel	De Gilden Van Brussel
hie_brb_erfgenamen_lothar	De Erfgenamen Van Lothar
hie_efr_fryske_frijheid	Fryske Frijheid
hie_efr_victual_brothers	Brokmerbrief
hie_efr_haadlingen	Haadlingen
hie_efr_brokmerbrief	The Victual Brothers
hie_efr_defeat_empire	Defeat the Empire
hie_efr_mennonite_refuge	Mennonite Refuge
hie_efr_frisian_parliament	Frisian Parliament
hie_fla_vlaamese_lakens	Vlaamse Lakens
hie_fla_guldensporenslag	Guldensporenslag
hie_fla_koningen_jeruzalem	Koningen Van Jeruzalem
hie_fla_vlaamse_renaissance	De Vlaamse Renaissance
hie_fla_brugse_beurs	De Brugse Beurs
hie_fla_trappisten_orden	Trappisten Orden
hie_fla_leeuw_wederom_brullen	The Leeuw Zal Wederom Brullen
hie_fri_upstalsboom	Upstalsboom
hie_fri_fryske_frijheid	Fryske Frijheid
hie_fri_signal_ships	Signal Ships
hie_fri_frisian_horse_breeding	Frisian Horse Breeding
hie_fri_zuider_embankments	Zuider Embankments
hie_fri_cross_dutchman	Cross of the Dutchman
hie_fri_stins	Stins
hie_gel_expansion_kastells	Expansion of the Kastells
hie_gel_imperial_elevation	Imperial Elevation
hie_gel_independent_spirit	Independent Spirit
hie_gel_gelderse_oorlogen	Gelderse Oorlogen
hie_gel_loot_payment	Loot as Payment
hie_gel_strategic_marriages	Strategic Marriages
hie_gel_kastell_kilns	Kastell Kilns
hie_hol_polders	Polders
hie_hol_handelscompagnieen	Handelscompagnieën
hie_hol_soldaten_ter_zee	Soldaten Ter Zee
hie_hol_de_admiraliteit	De Admiraliteit
hie_hol_gekoloniseerd	Gekoloniseerd!
hie_hol_nieuw_amsterdam	Nieuw Amsterdam
hie_hol_monopoly_op_het_oosten	Monopoly Op Het Oosten
hie_ned_dut_polders	Polders
hie_ned_dut_dijk_piercing	Dijk-Piercing
hie_ned_dut_wisselbank	Wisselbank
hie_ned_dut_mauritian_reforms	Mauritian Reforms
hie_ned_dut_haven_religious_refugees	Haven for Religious Refugees
hie_ned_dut_die_voorcompagnieen	Die Voorcompagnieën
hie_ned_dut_instructie_voor_de_admiraliteiten	Instructie Voor de Admiraliteiten
hie_ned_fri_polders	Polders
hie_ned_fri_dijk_piercing	Dijk-Piercing
hie_ned_fri_reunite_lowlands	Reunite the Lowlands
hie_ned_fri_new_heart_reformation	New Heart of the Reformation
hie_ned_fri_likedeelers_van_buit	Likedeelers Van Buit
hie_ned_fri_lessen_van_vrijheidsoorlogen	Lessen Van de Vrijheidsoorlogen
hie_ned_fri_instructie_voor_de_admiraliteiten	Independent Spirit
hie_ned_fle_polders	Polders
hie_ned_fle_dijk_piercing	Dijk-Piercing
hie_ned_fle_vlaamse_nederlander_renaissance	De Vlaamse Nederlander Renaissance
hie_ned_fle_permit_hagepreken	Permit the Hagepreken
hie_ned_fle_stadsrechten_grote_raad	Stadsrechten en de Grote Raad
hie_ned_fle_chart_globe	Chart the Globe
hie_ned_fle_stock_markets_upgraded_ports	Stock Markets and Upgraded Ports
hie_mor_mellahs	Mellah
hie_mor_for_gold	For Gold!
hie_mor_black_guard	Abid Al-Bukhari
hie_mor_mahdi_new_world	Mahdi in the New World
hie_mor_atlantic_pursuit	Atlantic Pursuits
hie_mor_sharifate	The Sharifate
hie_mor_makhzen	Makhzen
hie_azt_triple_alliance	The Triple Alliance
hie_azt_flower_wars	Xochiyaoyotl
hie_azt_military_schools	Telpochcalli
hie_azt_shorn_ones	Cuachicqueh
hie_azt_eagle_jaguars	Cuauhocelotl
hie_azt_travelling_merchants	Pochteca
hie_azt_right_to_rule	Tlatocayotl
hie_usa_price_freedom	The Price of Freedom
hie_usa_land_opportunity	Land of Opportunity
hie_usa_manifest_destiny	Manifest Destiny
hie_usa_lesson_valley_forge	Lessons of Valley Forge
hie_usa_founded_creed	Founded on a Creed
hie_usa_workshop_world	Workshop of the World
hie_usa_shining_city_hill	Shining City on a Hill
hie_per_the_qizilbash	The Qizilbash
hie_per_caravanserais	Caravanserais
hie_per_rokn_ol_dowleh	Rokn Ol-Dowleh
hie_per_persian_rug_production	Qali-Ye Irani
hie_per_jazayer	The Jazayer
hie_per_savaran_sapah_khorasan	Savaran-E Sepah-E Khorasan
hie_per_jazayerchi_tofangchi	Jazayerchi
hie_dan_kalmar_union	United at Kalmar
hie_dan_sound_toll	Øresundstolden
hie_dan_royal_waters	Kongens Strømme
hie_dan_folk_church	Folkekirken
hie_dan_danish_law	Danske Lov
hie_dan_sokadetakademie	Søkadetakademiet
hie_dan_stavnsband	Stavnsbånd
hie_fin_defend_isthmus	Concentrated at the Isthmus
hie_fin_saunas	Saunas
hie_fin_free_peasants	Free Yeomen
hie_fin_hakka_paale	Hakkaa Päälle!
hie_fin_turku_university	Turun Akatemia
hie_fin_ruotujakolaitos	Ruotujakolaitos
hie_fin_sisu	Sisu
hie_swe_protector_of_realm	Riksföreståndare
hie_swe_reformation	Liturgiska Striden
hie_swe_instrument_of_government	Regeringsformen
hie_swe_indelningsverket	Indelningsverket
hie_swe_go_to	Gå-På!
hie_swe_caroleans	Caroleans
hie_swe_dominium_marius_baltici	Dominium Maris Baltici
hie_inc_quipu	Quipu
hie_inc_mita	Mit'a System
hie_inc_royal_road	Qhapaq Nan
hie_inc_terrace_farming	Terrace Farming
hie_inc_warachikuy	Warachikuy
hie_inc_qullqas	Qullqas
hie_inc_tawantisuyu	Tawantisuyu
hie_pir_religious_apathy	Religious Apathy
hie_pir_plunder	Plunder!
hie_pir_grog_rationing	Grog Rationing
hie_pir_elected_captains	Elected Captains
hie_pir_standardized_punishments	Standardized Punishments
hie_pir_flexible_ranks	Flexible Ranks
hie_pir_true_maritime_republic	True Maritime Republic
hie_colonial_bri_pilgrims	The Pilgrim Fathers
hie_colonial_bri_lord_proprietors	Lord Proprietors
hie_colonial_bri_salutary_neglect	Salutary Neglect
hie_colonial_bri_great_awakening	The Great Awakening
hie_colonial_bri_heart_of_empire	Heart of the Empire
hie_colonial_bri_free_press	Freedom of the Press
hie_colonial_bri_rights_of_englishmen	Rights of Englishmen
hie_colonial_dut_private_companies	Geprivatise Handelscompagnieën
hie_colonial_dut_factories	Factorijen
hie_colonial_dut_patroon_system	Patroon System
hie_colonial_dut_liberalised_markets	Liberalised Markets
hie_colonial_dut_grand_design	Groot Desseyn
hie_colonial_dut_free_men	Vrijboeren
hie_colonial_dut_civil_liberties	Burgerlijke Vrijheden
hie_colonial_lat_national_militia	Milizia Nazionale
hie_colonial_lat_renaissance	Echi del Rinascimento
hie_colonial_lat_missions	Missio a Gentes
hie_colonial_lat_republican_traditions	Tradizioni Republicane
hie_colonial_lat_coastal_expeditions	Spedizioni Costiere
hie_colonial_lat_commercial_concessions	Concessioni Commerciali
hie_colonial_lat_new_world_navy	Marinai del Nuovo Mondo
hie_colonial_por_pau_brazil	Pau Brazil
hie_colonial_por_bandeirantes	Bandeirantes
hie_colonial_por_entradas	Entradas
hie_colonial_por_caboclo	Caboclo
hie_colonial_por_capoeira	Capoeira
hie_colonial_por_estrada_real	Estrada Real
hie_colonial_por_gold_rush	Corrida do Ouro
hie_colonial_spa_indian_reductions	Reducciones de Indios
hie_colonial_spa_real_audencia	Reales Audiencia y Virreinatos
hie_colonial_spa_presidio	Presidio
hie_colonial_spa_repartimiento	Repartimiento
hie_colonial_spa_purity_of_blood	Limpieza de Sangre
hie_colonial_spa_manilla_galleon	Galeón de Manila
hie_colonial_spa_creole_militia	Creole Militia
